{
  "width": 25,
  "height": 25,
  "grid": [
    ["#","#","#","#","#","#","#","#","#","#","#","#","#","#","#","#","#","#","#","#","#","#","#","#","#"],
    ["#","S","C","C","#","C","C","C","C","C","C","C","C","C","#","C","C","#","C","C","C","C","C","C","#"],
    ["#","C","#","#","#","C","#","#","#","#","#","C","X","C","#","C","C","#","C",".","C","#","#","C","#"],
    ["#","C","C","C","C","C","#","C","C","C","#","C","X","C","#","C","C","#","C","#","C","C","#","C","#"],
    ["#","#","#","#","#","#","#","C","#","C","C","C","C","C","#","C","C","#","C","#",".","C","#","C","#"],
    ["#","C","C","C","C","C","#",".","#",".","#","C","X","#","#","C","C","#","C",".",".","C","#","C","#"],
    ["#","C","C","C","C","C","C","C","C","C","C","C","#","#","C","C","C","#","C","C","C","C","#","C","#"],
    ["#","#","#","#","#","X","#","#","#","X","#","C","#","#","C","C","C","#","#","#","X","C","#","C","#"],
    ["#","C","C","C","C","C","C","C","C","C","#","C","#","C","C","C","C","C","C","C","C","C","C","C","#"],
    ["#","C",".","#","#","#","#","#","#","C","#","C","#","C","C","C","C","#","#","#","#","C","#","#","#"],
    ["#","C","#","#","C","C","C","C","#","C","#","C","#","C","C","C","C","#","C","C","C","C","C","C","#"],
    ["#","C","C","#","C","#","C","C","#","C","#","C","#","C","C","C","C","X","C",".",".","C","C","C","#"],
    ["#","C","C","#","C","#","C","C","X","C","#","C","#","C","C","C","C","X","C",".",".","C","C","#","#"],
    ["#","#","C","#","C","#","C","C",".","C",".","C","C","C","C","C","C","#","C","#","#","#","C","#","."],
    ["#","C","C","#","C",".","C","#","C","C","#","C","#","C","C","C",".","X","C","#","C","C","C","#","#"],
    ["#","C","#","#","C","C","C","C","C","#","#","C","#","C","C","C",".","X","C","#","C","C","C","C","E"],
    ["#","C","C","#","X","#","#","#","#","#","#","C","#","C","C","C",".","X","C","#","#","C","X","#","#"],
    ["#","#","C","C","C","C","C","C","C","C","C","C","#","C","C","#",".","X","C","C","C","C","#","#","#"],
    ["#","#","#","#","#","#","#","#","#","#","#","#","#","#","#","#","X","X","#","#","#","#","#","#","#"],
    [".",".",".",".",".",".",".",".",".",".",".",".",".",".",".",".",".",".",".",".",".",".",".",".","."],
    [".",".",".",".",".",".",".",".",".",".",".",".",".",".",".",".",".",".",".",".",".",".",".",".","."],
    [".",".",".",".",".",".",".",".",".",".",".",".",".",".",".",".",".",".",".",".",".",".",".",".","."],
    [".",".",".",".",".",".",".",".",".",".",".",".",".",".",".",".",".",".",".",".",".",".",".",".","."],
    [".",".",".",".",".",".",".",".",".",".",".",".",".",".",".",".",".",".",".",".",".",".",".",".","."],
    ["#",".",".",".",".",".",".",".",".",".",".",".",".",".",".",".",".",".",".",".",".",".",".",".","#"]
  ],
  "start": {"x": 1, "y": 0},
  "exit": {"x": 12, "y": 24},
  "coins": [],
  "enemies": [],
  "test": "Empty level with dots only"
}