{
  "width": 25,
  "height": 25,
  "grid": [
    ["#","#","#","#","#","#","#","#","#","#","#","#","S","#","#","#","#","#","#","#","#","#","#","#","#"],
    ["#","C",".",".",".",".",".",".",".",".",".",".",".",".",".",".",".",".",".",".",".",".",".",".","#"],
    ["#","C","C","C","C","C","C","C","C","C","С","#","#","#","#","#","#","#","#","#","#","#","#","#","#"],
    ["#","#","#","#","#","#","#","#","#","C","C","C","C","C","C","C","C","C","C","C","C","C","C","#","#"],
    ["#",".",".",".",".",".",".",".","#",".","#","#","#","#","#","#","#","#","#","#","#","#","#","#","#"],

    ["#","#","#","#","#","#","#","#","#",".","#","#","#","#","#","#","#","#","#","#","#","#","#","#","#"],
    ["#","#","#","#","#","#","#","#","#",".","#","#","#","#","#","#","#","#","#","#","#","#","#","#","#"],
    ["#","#",".",".",".",".",".",".",".",".","#","#","#","#","#","#",".",".",".",".",".",".",".","#","#"],
    ["#","#",".","#","#","#","#","#",".","#","#","#","#","#","#","#",".","#","#","#","#","#",".","#","#"],
    ["#","#",".","#","#","#",".",".",".","#","#","#","#","#","#","#",".","#","#","#","#","#",".","#","#"],

    ["#","X",".",".",".",".",".","#",".",".",".",".",".",".",".",".",".","С","С","С","С","С",".","#","#"],
    ["#",".",".",".",".",".",".","#",".",".",".",".",".",".",".","#",".","#","#","#","#","#",".","#","#"],
    ["#",".",".",".",".",".",".",".",".",".",".",".",".",".",".","#",".","#","#","#","#","#",".","#","#"],
    ["#",".",".",".",".",".",".",".",".",".",".",".",".",".",".","#",".","#","#","#","#","#",".","#","#"],
    ["#","#","#","#","#","#","#","#","#","#","#","#","#","#","#","#",".","#","#","#","#","#",".","#","#"],

    ["#","#","#","#","#","#","#","#","#","#","#","#","#","#","#","#",".","#","#","#","#","#",".","#","#"],
    ["#","#","#","#","#","#","#","#","#","#","#","#","#","#","#","#",".","#","#","#","#","#",".","#","#"],
    ["#","#",".",".",".",".",".",".",".",".",".",".",".",".",".",".",".",".",".",".",".",".",".",".","#"],
    ["#","#","E","#","#","#","#","#","#","#","#","#","#","#","#","#","#","#","#","#","#","#","#","#","#"],
    ["#","#",".","#","#","#","#","#","#","#","#","#","#","#","#","#","#","#","#","#","#","#","#","#","#"],

    ["#","#",".","#","#","#","#","#","#","#","#","#","#","#","#","#","#","#","#","#","#","#","#","#","#"],
    ["#","#",".","#","#","#","#","#","#","#","#","#","#","#","#","#","#","#","#","#","#","#","#","#","#"],
    ["#","#",".",".",".",".",".",".",".",".",".",".",".",".",".",".",".",".",".",".",".",".",".",".","."],
    ["#","#","#","#","#","#","#","#","#","#","#","#","#","#","#","#","#","#","#","#","#","#","#","#","."],
    ["#","#","#","#","#","#","#","#","#","#","#","#","#","#","#","#","#","#","#","#","#","#","#","#","."]
  ],
  "start": {"x": 12, "y": 0},
  "exit": {"x": 24, "y": 24},
  "coins": [
    {"x":1,"y":2},{"x":2,"y":2},{"x":3,"y":2},{"x":4,"y":2},{"x":5,"y":2},{"x":6,"y":2},{"x":7,"y":2},{"x":8,"y":2},{"x":9,"y":2},
    {"x":9,"y":3},{"x":10,"y":3},{"x":11,"y":3},{"x":12,"y":3},{"x":13,"y":3},{"x":14,"y":3},{"x":15,"y":3},{"x":16,"y":3},{"x":17,"y":3},{"x":18,"y":3},
    {"x":1,"y":23},{"x":2,"y":23},{"x":3,"y":23},{"x":4,"y":23},{"x":5,"y":23},{"x":6,"y":23},{"x":7,"y":23},{"x":8,"y":23}
  ],
  "enemies": [
    {"x":12,"y":12,"type":"moving"},
    {"x":18,"y":18,"type":"static"}
  ],
  "test": "##############################################"
}
