{
  "width": 25,
  "height": 25,
  "grid": [
    ["#","#","#","#","#","#","#","#","#","#","#","#","#","#","#","#","#","#","#","#","#","#","#","#","#"],
    ["#","S",".","#","C","C","C","C","C","C","C","#",".",".",".","#","C","C","C","C","C","C","C","C","#"],
    ["#",".","#","#","C","#",".","#","#","#",".","#","#","#","#","#","C","#","#","#","#","#","#","C","#"],
    ["#","C","#","#","C","C","C","C","C","C","C","C","C","C","C","#","C","C","C","C","C","C","#","C","#"],
    ["#","C","#","#","#","#","#","#","#","C","#","X","#","#","C","#","C","#","#","#","#","C","#","C","#"],
    ["#","C","C","C","#","C","C","C","C","C","#","C","C","C","C","C","C","C","C","C","C","C","#","C","#"],
    ["#","#","#","C","#","C","#","#","#","#","#","C","#","#","#","#","#","#","#","#","#","#","#","C","#"],
    ["#","X","X","C","#","C","#",".",".",".","#","C","#",".",".",".",".",".",".",".",".",".","#","C","#"],
    ["#","#","#","C","#","C","#","#","#","#","#","C","#","#","#","#","#","#","#","#","#","#","#","C","#"],
    ["#","C","C","C","#","C","C","C","C","C","C","C","C","C","C","C","#","C","C","C","#","C","C","C","#"],
    ["#","C","#","#","#","#","#","#","#","#","#","C","#","#","#","C","#","C","#","C","#","C","#","#","#"],
    ["#","C","#","C","C","C","#","C","C","C","C","C","C","C","#","C","#","C","C","C","C","C","C","C","#"],
    ["#","C","#","C","#","C","#","#","#","C","X",".","#","C","#","C","#","C","#","#","#","#","#","C","#"],
    ["#","C","#","C","#","C","C","C","C","C","#","C","C","C","#","C","#","C","#","X","X","X","#","C","#"],
    ["#","C","#","C","#","#",".",".",".","#","#","C","#","#","#","C","#","C","#","#","#","#","#","C","#"],
    ["#","C","#","C","C","C","C","C","C","C","C","C","C","C","C","C","#","C","C","C","#","C","C","C","#"],
    ["#","C","#","#","#","#","#","#","#","#","#","#","#","#","C","#","#","#","C","C","#","C","C","#","#"],
    ["#","C","C","C","С","C","C","C","C","C","C","C","С","C","C","#","#","C","C","C","C","C","C","C","#"],
    ["#","#","#","#","#","#","#","#","#","#","#","#","#","#","#","C","#","#","#","#","#","#","#","E","#"],
    ["#","X","X","C","#","C","X","X","X","X","#","C","X","X","X","C","X","X","X","X","X","X","#","C","#"],
    ["#","#","#","C","#","C","#","#","#","#","#","C","#","#","#","#","#","#","#","#","#","#","#","C","#"],
    ["#","C","C","C","#","C","C","C","#","C","C","C","#","C","C","C","#","C","C","C","#","C","C","C","#"],
    ["#","C","#","#","#","#","#","#","#","#","#","#","#","#","#","#","#","#","#","#","#","#","#","#","#"],
    ["#","C","C","C","C","C","C","C","C","C","C","C","C","C","C","C","C","C","C","C","C","C","C","C","#"],
    ["#","#","#","#","#","#","#","#","#","#","#","#","#","#","#","#","#","#","#","#","#","#","#","#","#"]
  ],
  "start": {"x": 1, "y": 1},
  "exit": {"x": 20, "y": 1},
  "coins": [],
  "enemies": [],
  "test": "Strategic slide maze with deadly corridors"
}